# 该行请勿删除。第二行记录地图行、列数、类型(0:收集,1:迷宫)；三行为视点初始位置；四行为目标位置，可为空；五行以后为地图数组
36 12 0
6 18
6 20
1 1 2 2 3 1 1 1 2 2 3 1 
2 2 1 2 2 1 2 2 1 2 2 1 
3 2 2 1 2 1 3 2 2 1 2 1 
4 3 3 2 2 2 4 3 3 2 2 2 
3 4 3 3 2 1 3 4 3 3 2 1 
3 3 2 3 2 2 3 3 2 3 2 2 
1 1 2 2 3 1 1 1 2 2 3 1 
2 2 1 2 2 1 2 2 1 2 2 1 
3 2 2 1 2 1 3 2 2 1 2 1 
4 3 3 2 2 2 4 3 3 2 2 2 
3 4 3 3 2 1 3 4 3 3 2 1 
3 3 2 3 2 2 3 3 2 3 2 2 
1 1 2 2 3 1 1 1 2 2 3 1 
2 2 1 2 2 1 2 2 1 2 2 1 
3 2 2 1 2 1 3 2 2 1 2 1 
4 3 3 2 2 2 4 3 3 2 2 2 
3 4 3 3 2 1 3 4 3 3 2 1 
3 3 2 3 2 2 3 3 2 3 2 2 
1 1 2 2 3 1 1 1 2 2 3 1 
2 2 1 2 2 1 2 2 1 2 2 1 
3 2 2 1 2 1 3 2 2 1 2 1 
4 3 3 2 2 2 4 3 3 2 2 2 
3 4 3 3 2 1 3 4 3 3 2 1 
3 3 2 3 2 2 3 3 2 3 2 2 
1 1 2 2 3 1 1 1 2 2 3 1 
2 2 1 2 2 1 2 2 1 2 2 1 
3 2 2 1 2 1 3 2 2 1 2 1 
4 3 3 2 2 2 4 3 3 2 2 2 
3 4 3 3 2 1 3 4 3 3 2 1 
3 3 2 3 2 2 3 3 2 3 2 2 
1 1 2 2 3 1 1 1 2 2 3 1 
2 2 1 2 2 1 2 2 1 2 2 1 
3 2 2 1 2 1 3 2 2 1 2 1 
4 3 3 2 2 2 4 3 3 2 2 2 
3 4 3 3 2 1 3 4 3 3 2 1 
3 3 2 3 2 2 3 3 2 3 2 2