# 该行请勿删除。第二行记录地图行、列数、类型(0:收集,1:迷宫)；三行为视点初始位置；四行为目标位置，可为空；五行以后为地图数组
22 22 1
20 0
0 20
3 3 3 3 3 3 3 3 3 3 3 3 3 3 3 3 3 3 3 3 1 3
3 1 1 1 1 1 1 1 3 3 1 1 1 1 1 1 1 1 1 3 1 3
3 1 3 3 3 3 3 1 3 1 1 3 3 3 1 3 3 3 3 3 1 3
3 1 3 1 3 1 1 1 3 3 1 3 1 3 1 1 1 1 1 1 1 3
3 1 3 1 3 3 3 1 1 3 1 3 1 3 3 3 3 3 1 3 3 3
3 1 3 1 3 1 3 3 1 3 1 3 1 1 1 1 1 3 1 1 1 3
3 1 3 1 1 1 1 3 1 3 1 3 3 3 3 3 1 3 3 3 1 3
3 1 3 3 3 3 1 3 1 3 1 3 1 1 1 3 1 3 1 1 1 3
3 1 1 1 1 3 1 3 1 3 1 1 1 3 1 3 1 3 3 3 3 3
3 1 3 3 3 3 1 3 3 3 3 3 3 3 1 3 1 1 1 3 1 3
3 1 3 1 1 1 1 1 1 1 1 1 1 1 1 3 1 3 3 3 1 3
3 1 3 3 3 1 3 3 3 3 3 3 3 3 1 3 1 3 1 1 1 3
3 1 3 1 1 1 3 1 1 1 1 1 1 1 1 3 1 3 1 3 3 3
3 1 3 1 3 1 3 3 3 3 3 3 3 3 1 3 1 1 1 3 1 3
3 1 1 1 3 1 1 1 1 3 1 1 1 3 1 3 3 3 1 3 1 3
3 1 3 1 3 3 3 3 1 3 3 3 1 1 1 1 1 3 1 3 1 3
3 1 3 1 1 1 1 3 1 1 1 3 1 3 3 3 1 1 1 3 1 3
3 3 3 3 1 3 3 3 3 3 3 3 1 3 1 3 1 3 3 3 1 3
3 1 1 1 1 1 1 1 1 1 1 3 1 3 1 3 1 3 1 1 1 3
3 3 3 3 1 3 3 3 3 3 3 3 1 3 1 3 3 3 1 3 3 3
1 1 1 1 1 3 1 1 1 1 1 1 1 1 1 1 1 1 1 1 1 3
3 3 3 3 3 3 3 3 3 3 3 3 3 3 3 3 3 3 3 3 3 3